######
#S...#
# ## #
#  # #
######
