######
#S...#
# ## #
#. #E#
######