#####################
#        #          #
#  ####  #  ####### # 
#  # S   #          #
#  #   #########   ##
#  #             #  #
#  ###########  ##  #
#             #  # ##         
#####  ###### #  ####
#   #  #      #  #  #               
#   #     #####  #  #
#   #  #      #  #  # 
#   #######  ##  ## # 
#          #      # #   
###  ####  ##### # ## 
#    #            # #         
#    #  ########### # 
#  #              # #       
#    ################        
###  ################
#        #          #     
#  ####  #  #########
#  #     #          #
#  #  ##########  ###
#  #             #  #
#  ###########  ##  #
#             #  #  #
#####  ###### #  ####
###   #      #  #  ##
#   #  #  #####  #  #
#   #         #  #  # 
#   #######  ##  ## #   
#          #      # #   
##########   ########
#######       #######
#        #          # 
#  ####  #  #########
#  #     #          # 
#  #  ##########  ###
#  #             #  #  
#  ##### #####  ##  #
#             #  #  #    
#####  ######    ####
#   #  #      #  #  #    
#   #  #  #####  #  #
#   #  #      #  #  #  
#   #######  ##  ## #  
#          #      # #    
###  ####  #####  # #
#    #  #         # #         
#    #  ########### #
#   #              ##        
##     ###   ########        
### #######   #######
#        #          #        
#  ####  #  #########
#  #     #          #   
#  #  ##########  ###  
#  #             #  #    
#  ###########  ##  #
#             #  #  #         
#####  ###### #  ####
#   #  #      #  #  #     
#   #  #  #####  #  #
#   #  #      #  #  #
#   #######  ##  ## #  
#          #      # #    
#             #  #  #      
#####  ###### #  ####
#   #  #      #  #  #    
#   #  #  #####  #  #  
#   #  #      #  #  #  
#   #######  ##  ## #  
#          #      # #    
#   #######  ##  ## #  
#          #      # #  
#             #  #  #       
#####  ###### #  ####
#   #  #      #  #  #      
#   #  #  #####  #  #  
#   #  #      #  #  #   
#   #######  ##  ## # 
#          #      # # 
#   ######    ##  ###   
#          #      # #     
#             #  #  #        
#####  ###### #  ####
#   #  #      #  #  #      
#   #  #  #####  #  #  
#   #         #  #  #    
#   #######  ##  ## #
#          #      # #  
#   #######  ##  ## #   
# #        #      # #    
#             #  #  #        
#####  ###### #  ####
#   #  #      ## #  #      
#   #  #  #####  #  #  
#   #  #      #  #  #    
#   #######  ##  ## # 
#   E       #  #    #
   ##    #         ##
#####################

































































































