##############################################################################################################
# ############### S ###################### #########             ##################################   ########                                          
#      ###########         ############                                                                      #
#########################          ############################### #######################################   #                                                                                    
#    #                                                                                                       #
###########################################################                                                  #                                            
#   ##                                                    #######################                            #                        
#   ######## E #                                                                        ######################                      
#    #########################################################################################               #                                                                                         
#                                                                                                            #
##############################################################################################################












































