######
#S...#
#### #
#  E #
######
