######
#S...#
# ## #
#  #E#
######
