##########
#S      E#
# ###### #
#        #
##########






