#####  ########
#S      H     *
#  #########  #
L  #       #  #
#  #  ###  #  #
#  #  #X#  #  #
#  #### ###  # 
#            # 
#####__-#######