########
#S    ###
##    # #
####   ##
# ###   #
# E    ##
##########
