###############
#S.........#..E#
#.#######.#.#.#.
#.......#.#.#.#.
#.#####.#.#.#.#.
#.....#.#.#.#.#.
#####.#.#.#.#.#.
#.....#...#...#.
###############
