####################
#S...............#.#
#.###.#####.###.##.##
#...#.....#.#...#...#
#.#####.#.#.###.#####
#.....#.#.#...#.....#
#####.#.#.###.#######
#.....#.#.....#.....#
#.#######.#########.#
#...........#.......#
#.#######.###.#####.#
#.#.....#...#.....#.#
#.#.###.###.#####.#.#
#.E.#...#.......#.#.#
#...###.#.#####.###.#
#####...#.........#.#
#.#.#####.#######.#.#
#.#...............#.#
#.#.#############.#.#
#..................##
####################




