######
# ...#
# ## #
#  #E#
######
