######
#S..E#
# ## #
#  #E#
######
