#########
#S#.#.#E#
#.#.#.#.#
#.#.#.#.#
#.#.#.#.#
#########
